11111111111111
10001000000C01
1C000P11101001
1000000E00C001
11111111111111
