11111111111111
100010P0000C01
1C000011101001
1000000E00C001
11111111111111
